R 500 500
 NO ./purplestone.xpm
 SO ./bluestone.xpm
 WE ./redbrick.xpm
 EA ./wood.xpm
 S ./barrel.xpm
 F 220,100,0
 C 225,30,0


1111221111111111111111111
1000000000110000000000001
0011000001110000002000001
1001000000000000000000001
111111111011000001110000000000001
100000000011000001110111111111111
11110111111111011100000010N01
11110111111111011101010010001
11111111111111111111111111001
11111111111111111111111111001
11000000110101011100000010001
10002000000000001100000010001
10000000000000001101010010201
1111111111111111111111111111111
1111111111111111111111111111111
1100000111010101111101111000111
11110111 1110101 101111010001
11111111 1111111 111111111111